 I - Se 'n questo dir presente si contene
 II - Se unqua fu neun, che di servire
 III - Perfetto onore, quanto al mi' parere
 IV - Amico mio, per Dio, prendi conforto
 V - I' vivo di speranza, e cosí face
 VI - Chi vuole aver gioiosa vita intera
 VII - Molto m'è viso che sia da blasmare
 VIII - Ahi, buona fede a me forte nemica
 IX - Omo non fu ch'amasse lealmente
 X - D'amore vene ad om tutto piacere
 XI - Avegna che d'amor aggia sentito
 XII - Bench'i' ne sia alquanto intralasciato
 XIII - Ne l'amoroso affanno son tornato
 XIV - I' sono alcuna volta domandato
 XV - Otto comandamenti face Amore
 XVI - Nobil pulzella dolce ed amorosa
 XVII - Com'io mi lamentai per lo dolore
 XVIII - Partitevi, messer, da piú cherere
 XIX - Gentil mia donna, ciò che voi tenere
 XX - Messer, l'umilitá donde parlate
 XXI - Madonna, lo parlar ch'ora mostrate
 XXII - I' sí mi posso, lassa, lamentare
 XXIII - Tutto ch'i' mi lamenti nel mi' dire
 XXIV - I' son congiunto sí a voi di fede
 XXV - Non oso nominare apertamente
 XXVI - Nobile pulzelletta ed amorosa
 XXVII - Dappoi ch'è certo che la tua bieltate
 XXVIII - Quand'io mi vo' ridure a la ragione
 XXIX - Per questo, amico, ch'io t'aggio mostrato
 XXX - Noi semo in un cammino e dovén gire
 XXXI - Grazie ti rendo, amico, a mio podere
 XXXII - Se in me avesse punto di savere
 XXXIII - Alcuna gente, part'io mi dimoro
 XXXIV - Sed io vivo pensoso ed ho dolore
 XXXV - Morte gentil, rimedio de' cattivi
 XXXVI - Tristo e dolente e faticato molto
 XXXVII - S'on si trovò giá mai in vita povra
 XXXVIII - Deh, che ho detto di tornare in possa
 XXXIX - Nessuna cosa tengo sia sí grave
 XL - I' sí mi tengo, lasso! a mala posta
 XLI - I' ragionai l'altrier con uno antico
 XLII - I' credo, Amor, che 'nfin ch'i' non dimagro
 XLIII - Amico, tu fai mal che ti sconforti
 XLIV - Amore, i' aggio vostro dire inteso
 XLV - Talor credete voi, Amor, ch'i' dorma
 XLVI - Sed io comincio dir, che pai' alpestro
 XLVII - In quella guisa, Amor, che tu richiedi
 XLVIII - Un poco esser mi pare isviatetto
 XLIX - Como ch'Amor mi meni tuttavolta
 L - La pena che sentí Cato di Roma
 LI - Dicendo i' vero, altrui fallar non curo
 LII - Due malvagie maniere di mentire
 LIII - Non posso rafrenar lo mi' talento
 LIV - Quando l'Amore il su' servo partito
 LV - Vita mi piace d'om che si mantene
 LVI - I' son ben certo, dolce mio amore
 LVII - De lo piacere ch'or presente presi
 LVIII - L'attender ched'i' faccio con paura
 LIX - I' sí vorrei cosí aver d'Amore
 LX - Ne lo disio, dove Amor mi tene
 LXI - Però ch'i' ho temenza di fallare 